persist - persistent
achv - achievement
diff - difference
stat - statistics
ctrl - controller
curr - current
inst - instance
iss - issue
equ - equipment
dev - developers 
set - settings
btl - bullet
ptr - patron
cmn - common
msc - music
pos - position
scr - screen
ind - index
num - number
btn - button
bgi - background-image
bgc - background-color
img - image
sys - system
str - string
snd - sound
spd - speed
cls - collision
pre - previous
lvl - level
val - value 
ref - reference
jrn - journal
cnt - count
inv - inventory
rmv - remove
env - environment

bg - background
el - element
sv - saves/save
ld - load
fp - first_part
sp - second_part
mv - moving
hp - healph